border_size=1
usage=map

_off^_usr   , _off^_usr   , _off^_usr   , _off^_usr   , _off^_usr   , _off^_usr   , _off^_usr   , _off^_usr   , _off^_usr   , _off^_usr   , _off^_usr   , _off^_usr   , _off^_usr   , _off^_usr   , _off^_usr   , _off^_usr   , _off^_usr   , _off^_usr   , _off^_usr   , _off^_usr   , _off^_usr   , _off^_usr   , _off^_usr   , _off^_usr   , _off^_usr   , _off^_usr   , _off^_usr   , _off^_usr   , _off^_usr   
_off^_usr   , _off^_usr   , _off^_usr   , _off^_usr   , _off^_usr   , _off^_usr   , _off^_usr   , _off^_usr   , _off^_usr   , _off^_usr   , _off^_usr   , _off^_usr   , _off^_usr   , _off^_usr   , _off^_usr   , _off^_usr   , _off^_usr   , _off^_usr   , _off^_usr   , _off^_usr   , _off^_usr   , _off^_usr   , _off^_usr   , _off^_usr   , _off^_usr   , _off^_usr   , _off^_usr   , _off^_usr   , _off^_usr   
_off^_usr   , _off^_usr   , _off^_usr   , _off^_usr   , _off^_usr   , _off^_usr   , _off^_usr   , _off^_usr   , _off^_usr   , _off^_usr   , _off^_usr   , _off^_usr   , Wwf         , _off^_usr   , Gg          , _off^_usr   , Gg          , _off^_usr   , _off^_usr   , _off^_usr   , _off^_usr   , _off^_usr   , _off^_usr   , _off^_usr   , _off^_usr   , _off^_usr   , _off^_usr   , _off^_usr   , _off^_usr   
_off^_usr   , _off^_usr   , _off^_usr   , _off^_usr   , _off^_usr   , _off^_usr   , _off^_usr   , _off^_usr   , _off^_usr   , _off^_usr   , Gg          , Ww          , Gs^Fp       , Wwf         , Gs          , Gg          , Hh          , Rd          , Dd^Dc       , _off^_usr   , _off^_usr   , _off^_usr   , _off^_usr   , _off^_usr   , _off^_usr   , _off^_usr   , _off^_usr   , _off^_usr   , _off^_usr   
_off^_usr   , _off^_usr   , _off^_usr   , _off^_usr   , _off^_usr   , _off^_usr   , _off^_usr   , _off^_usr   , Gg          , Gg          , Gs          , Ww          , Ww          , Wwf         , Gll         , Gs^Fp       , Rd          , Rd          , Gs          , Gs          , Gd          , _off^_usr   , _off^_usr   , _off^_usr   , _off^_usr   , _off^_usr   , _off^_usr   , _off^_usr   , _off^_usr   
_off^_usr   , _off^_usr   , _off^_usr   , _off^_usr   , _off^_usr   , _off^_usr   , Gs          , Gg          , Gs          , Gs          , Hh          , Gs          , Ww          , Gs          , Ds          , Mm          , Rd          , Gs          , Gd^Fdf      , Gd          , Ww          , Ww          , Gd          , _off^_usr   , _off^_usr   , _off^_usr   , _off^_usr   , _off^_usr   , _off^_usr   
_off^_usr   , _off^_usr   , _off^_usr   , _off^_usr   , _off^_usr   , Gg          , Gs          , Gs          , Gd          , Gll^Fmf     , Mm^Vhh      , Ww          , Gs^Fp       , Gd          , Rd          , Rd          , Wwf         , Gd          , Re^Vct      , Hhd         , Ww          , Hhd         , Re          , Gd          , _off^_usr   , _off^_usr   , _off^_usr   , _off^_usr   , _off^_usr   
_off^_usr   , _off^_usr   , _off^_usr   , _off^_usr   , Gg^Gvs      , Gs          , Md          , Gs^Fp       , Gd          , Ds^Edp      , Ww          , Ww          , Gd          , Rd          , Chw         , Rd          , Gd^Fdf      , Gd          , Rb          , Wwf         , Gll^Fmf     , Ww          , Re          , Gs          , Gs^Gvs      , _off^_usr   , _off^_usr   , _off^_usr   , _off^_usr   
_off^_usr   , _off^_usr   , _off^_usr   , _off^_usr   , Gs          , Gs          , Gd          , Gd          , Gd          , Ww          , Sm          , Ds          , Hh          , Rd          , Ww^Bw|      , Rd          , Hh^Vhh      , Mm          , Gd          , Wwf         , Ww          , Ww          , Gd          , Gs          , Gs          , _off^_usr   , _off^_usr   , _off^_usr   , _off^_usr   
_off^_usr   , _off^_usr   , _off^_usr   , Gd          , Rb          , Rb          , Ww          , Dd^Do       , Ww          , Ww          , Ww          , Ss^Vhs      , Wwf         , Ww          , Ww^Bw|      , Ww          , Wwf         , Gd^Fmw      , Gd          , Hhd         , Ww          , Dd^Do       , Gd          , Md          , Gs          , Gg          , _off^_usr   , _off^_usr   , _off^_usr   
_off^_usr   , _off^_usr   , _off^_usr   , Gd          , Hhd         , Ww          , Gll^Fmf     , Ww          , Hhd         , Mm          , Ww          , Wwr         , Ce          , Cd          , 4 Kd        , Cd          , Ce          , Ww          , Ww          , Md          , Ww          , Gd          , Gd          , Gs^Fp       , Gs          , Gs          , _off^_usr   , _off^_usr   , _off^_usr   
_off^_usr   , _off^_usr   , _off^_usr   , Ww          , Ww          , Ww          , Wwf         , Wwf         , Gd          , Gd          , Ww          , Chw         , Dd^Do       , Rr          , Rr          , Rr          , Dd^Do       , Chw         , Wwr         , Ww          , Sm          , Ww          , Ds^Edp      , Gd          , Gs          , Gg          , _off^_usr   , _off^_usr   , _off^_usr   
_off^_usr   , _off^_usr   , _off^_usr   , Gd          , Gd          , Hhd         , Re^Vct      , Rb          , Mm          , Gd^Fmw      , Wwf         , Ce          , Rr          , Rr          , Rr          , Rr          , Rr          , Ce          , Wwf         , Ss^Vhs      , Ds          , Ww          , Mm^Vhh      , Gll^Fmf     , Gs          , Gg          , _off^_usr   , _off^_usr   , _off^_usr   
_off^_usr   , _off^_usr   , _off^_usr   , Gs          , Gs          , Gd^Fdf      , Gd          , Gd          , Gd^Fdf      , Hh^Vhh      , Ww          , Cd          , 2 Kd        , Rr          , Rr          , Rr          , 3 Kd        , Cd          , Ww          , Hh          , Gs          , Ww          , Ww          , Hh          , Gs          , Gs          , _off^_usr   , _off^_usr   , _off^_usr   
_off^_usr   , _off^_usr   , _off^_usr   , Dd^Dc       , Rd          , Gs          , Rd          , Wwf         , Rd          , Rd          , Ww^Bw/      , Ww^Bw/      , Cd          , Rr          , Dd^Do       , Rr          , Cd          , Ww^Bw\      , Ww^Bw\      , Rd          , Rd          , Gs^Fp       , Ww          , Gs          , Ww          , Gs          , _off^_usr   , _off^_usr   , _off^_usr   
_off^_usr   , _off^_usr   , _off^_usr   , Rd          , Hh          , Rd          , Mm          , Rd          , Rd          , Chw         , Rd          , Ww          , Wwf         , Ce          , Chw         , Ce          , Wwf         , Ww          , Rd          , Chw         , Rd          , Gd          , Gs          , Ww          , Gs^Fp       , Ww          , _off^_usr   , _off^_usr   , _off^_usr   
_off^_usr   , _off^_usr   , _off^_usr   , Gg          , Gg          , Gs^Fp       , Gll         , Ds          , Gd          , Rd          , Gs          , Hh          , Ss^Vhs      , Wwr         , Ww          , Ww          , Gd^Fmw      , Hh^Vhh      , Gd^Fdf      , Rd          , Rd          , Ds          , Gll         , Wwf         , Wwf         , Wwf         , _off^_usr   , _off^_usr   , _off^_usr   
_off^_usr   , _off^_usr   , _off^_usr   , _off^_usr   , Gg          , Gs          , Wwf         , Gd          , Ww          , Gs^Fp       , Ww          , Ds          , Sm          , Ww          , Mm          , Gd          , Gd          , Mm          , Gd          , Wwf         , Rd          , Mm          , Gs^Fp       , Gs          , Gs          , _off^_usr   , _off^_usr   , _off^_usr   , _off^_usr   
_off^_usr   , _off^_usr   , _off^_usr   , _off^_usr   , _off^_usr   , Wwf         , Gs^Fp       , Ww          , Gs          , Ww          , Mm^Vhh      , Ww          , Ww          , Ww          , Ww          , Hhd         , Wwf         , Rb          , Re^Vct      , Gd          , Gd          , Rd          , Hh          , Gs          , _off^_usr   , _off^_usr   , _off^_usr   , _off^_usr   , _off^_usr   
_off^_usr   , _off^_usr   , _off^_usr   , _off^_usr   , _off^_usr   , Wwf         , Ww          , Ww          , Gs          , Hh          , Gll^Fmf     , Ds^Edp      , Gd          , Gd          , Dd^Do       , Ww          , Gll^Fmf     , Wwf         , Hhd         , Gd^Fdf      , Gs          , Rd          , Rd          , Gg          , _off^_usr   , _off^_usr   , _off^_usr   , _off^_usr   , _off^_usr   
_off^_usr   , _off^_usr   , _off^_usr   , _off^_usr   , _off^_usr   , _off^_usr   , _off^_usr   , Gs          , Gs          , Gs          , Gs          , Gd          , Gs^Fp       , Gd          , Gd          , Ww          , Ww          , Ww          , Ww          , Gd          , Gs          , Dd^Dc       , _off^_usr   , _off^_usr   , _off^_usr   , _off^_usr   , _off^_usr   , _off^_usr   , _off^_usr   
_off^_usr   , _off^_usr   , _off^_usr   , _off^_usr   , _off^_usr   , _off^_usr   , _off^_usr   , _off^_usr   , _off^_usr   , Gs          , Gs          , Gs          , Gg          , Md          , Gs          , Rb          , Rb          , Hhd         , Ww          , Gd          , _off^_usr   , _off^_usr   , _off^_usr   , _off^_usr   , _off^_usr   , _off^_usr   , _off^_usr   , _off^_usr   , _off^_usr   
_off^_usr   , _off^_usr   , _off^_usr   , _off^_usr   , _off^_usr   , _off^_usr   , _off^_usr   , _off^_usr   , _off^_usr   , _off^_usr   , _off^_usr   , Gg          , Gg          , Gg          , Gg^Gvs      , Gs          , Gd          , Gd          , _off^_usr   , _off^_usr   , _off^_usr   , _off^_usr   , _off^_usr   , _off^_usr   , _off^_usr   , _off^_usr   , _off^_usr   , _off^_usr   , _off^_usr   
_off^_usr   , _off^_usr   , _off^_usr   , _off^_usr   , _off^_usr   , _off^_usr   , _off^_usr   , _off^_usr   , _off^_usr   , _off^_usr   , _off^_usr   , _off^_usr   , _off^_usr   , _off^_usr   , _off^_usr   , _off^_usr   , _off^_usr   , _off^_usr   , _off^_usr   , _off^_usr   , _off^_usr   , _off^_usr   , _off^_usr   , _off^_usr   , _off^_usr   , _off^_usr   , _off^_usr   , _off^_usr   , _off^_usr   
_off^_usr   , _off^_usr   , _off^_usr   , _off^_usr   , _off^_usr   , _off^_usr   , _off^_usr   , _off^_usr   , _off^_usr   , _off^_usr   , _off^_usr   , _off^_usr   , _off^_usr   , _off^_usr   , _off^_usr   , _off^_usr   , _off^_usr   , _off^_usr   , _off^_usr   , _off^_usr   , _off^_usr   , _off^_usr   , _off^_usr   , _off^_usr   , _off^_usr   , _off^_usr   , _off^_usr   , _off^_usr   , _off^_usr   
