border_size=1
usage=map

_off^_usr   , _off^_usr   , _off^_usr   , _off^_usr   , _off^_usr   , _off^_usr   , _off^_usr   , _off^_usr   , _off^_usr   , _off^_usr   , _off^_usr   , _off^_usr   , _off^_usr   , _off^_usr   , _off^_usr   , _off^_usr   , _off^_usr   , _off^_usr   , _off^_usr   , _off^_usr   , _off^_usr   , _off^_usr   , _off^_usr   , _off^_usr   , _off^_usr   , _off^_usr   , _off^_usr   , _off^_usr   , _off^_usr   
_off^_usr   , _off^_usr   , _off^_usr   , _off^_usr   , _off^_usr   , _off^_usr   , _off^_usr   , _off^_usr   , _off^_usr   , _off^_usr   , _off^_usr   , _off^_usr   , _off^_usr   , _off^_usr   , _off^_usr   , _off^_usr   , _off^_usr   , _off^_usr   , _off^_usr   , _off^_usr   , _off^_usr   , _off^_usr   , _off^_usr   , _off^_usr   , _off^_usr   , _off^_usr   , _off^_usr   , _off^_usr   , _off^_usr   
_off^_usr   , _off^_usr   , _off^_usr   , _off^_usr   , _off^_usr   , _off^_usr   , _off^_usr   , _off^_usr   , _off^_usr   , _off^_usr   , _off^_usr   , _off^_usr   , _off^_usr   , _off^_usr   , _off^_usr   , _off^_usr   , _off^_usr   , _off^_usr   , _off^_usr   , _off^_usr   , _off^_usr   , _off^_usr   , _off^_usr   , _off^_usr   , _off^_usr   , _off^_usr   , _off^_usr   , _off^_usr   , _off^_usr   
_off^_usr   , _off^_usr   , _off^_usr   , _off^_usr   , _off^_usr   , _off^_usr   , _off^_usr   , _off^_usr   , _off^_usr   , _off^_usr   , Gg          , Ww          , Gs^Fp       , Gg          , Gg          , Gg          , Hh          , Rd          , Gg          , _off^_usr   , _off^_usr   , _off^_usr   , _off^_usr   , _off^_usr   , _off^_usr   , _off^_usr   , _off^_usr   , _off^_usr   , _off^_usr   
_off^_usr   , _off^_usr   , _off^_usr   , _off^_usr   , _off^_usr   , _off^_usr   , _off^_usr   , _off^_usr   , Gg          , Gg          , Gg          , Ww          , Ww          , Gg          , Gg          , Gs^Fp       , Rd          , Rd          , Gg          , Gg          , Gg          , _off^_usr   , _off^_usr   , _off^_usr   , _off^_usr   , _off^_usr   , _off^_usr   , _off^_usr   , _off^_usr   
_off^_usr   , _off^_usr   , _off^_usr   , _off^_usr   , _off^_usr   , _off^_usr   , Gg          , Gg          , Gg          , Gg          , Hh          , Gg          , Wwf         , Gg          , Gg          , Mm          , Rd          , Gg          , Gs^Fp       , Gg          , Ww          , Ww          , Gg          , _off^_usr   , _off^_usr   , _off^_usr   , _off^_usr   , _off^_usr   , _off^_usr   
_off^_usr   , _off^_usr   , _off^_usr   , _off^_usr   , _off^_usr   , Gg          , Gg          , Gg          , Gg          , Gs^Fp       , Mm^Vhh      , Ww          , Gs^Fp       , Gg          , Rd          , Rd          , Gg          , Gg          , Gg          , Hh          , Ww          , Hh          , Gg          , Gg          , _off^_usr   , _off^_usr   , _off^_usr   , _off^_usr   , _off^_usr   
_off^_usr   , _off^_usr   , _off^_usr   , _off^_usr   , Gg          , Gg          , Gg          , Gs^Fp       , Gg          , Ds          , Ww          , Ww          , Gg          , Gg          , Ch          , Gg          , Gg^Fet      , Gg          , Gg          , Gg          , Gg          , Ww          , Gg          , Gg          , Gg          , _off^_usr   , _off^_usr   , _off^_usr   , _off^_usr   
_off^_usr   , _off^_usr   , _off^_usr   , _off^_usr   , Gg          , Gg          , Gg          , Gg          , Gg          , Wwf         , Ss          , Ds          , Hh          , Gg          , Ww^Bw|      , Gg          , Hh^Vhh      , Mm          , Gg          , Gg          , Ww          , Wwf         , Gg          , Gg          , Gg          , _off^_usr   , _off^_usr   , _off^_usr   , _off^_usr   
_off^_usr   , _off^_usr   , _off^_usr   , Gg          , Gg          , Gg          , Wwf         , Ds          , Ww          , Ww          , Ww          , Ss^Vhs      , Wwf         , Ww          , Ww^Bw|      , Ww          , Wwf         , Gs^Fp       , Gg          , Hh          , Ww          , Ds          , Gg          , Gg          , Gg          , Gg          , _off^_usr   , _off^_usr   , _off^_usr   
_off^_usr   , _off^_usr   , _off^_usr   , Gg          , Hh          , Ww          , Gg          , Ww          , Hh          , Mm          , Ww          , Ww          , Ch          , Ch          , 4 Kh        , Ch          , Ch          , Ww          , Ww          , Mm          , Ww          , Gg          , Gg          , Gs^Fp       , Gg          , Gg          , _off^_usr   , _off^_usr   , _off^_usr   
_off^_usr   , _off^_usr   , _off^_usr   , Ww          , Ww          , Ww          , Gg          , Gg          , Gg          , Gg          , Ww          , Ch          , Gg^Vh       , Rr          , Rr          , Rr          , Gg^Vh       , Ch          , Ww          , Ww          , Ss          , Wwf         , Ds          , Gg          , Gg          , Gg          , _off^_usr   , _off^_usr   , _off^_usr   
_off^_usr   , _off^_usr   , _off^_usr   , Gg          , Gg          , Hh          , Gg          , Gg          , Mm          , Gs^Fp       , Wwf         , Ch          , Rr          , Rr          , Rr          , Rr          , Rr          , Ch          , Wwf         , Ss^Vhs      , Ds          , Ww          , Mm^Vhh      , Gs^Fp       , Gg          , Gg          , _off^_usr   , _off^_usr   , _off^_usr   
_off^_usr   , _off^_usr   , _off^_usr   , Gg          , Gg          , Gs^Fp       , Gg          , Gg          , Gg^Fet      , Hh^Vhh      , Ww          , Ch          , 2 Kh        , Rr          , Rr          , Rr          , 3 Kh        , Ch          , Ww          , Hh          , Gg          , Ww          , Ww          , Hh          , Gg          , Gg          , _off^_usr   , _off^_usr   , _off^_usr   
_off^_usr   , _off^_usr   , _off^_usr   , Gg          , Rd          , Gg          , Rd          , Gg          , Gg          , Gg          , Ww^Bw/      , Ww^Bw/      , Ch          , Rr          , Gg^Vh       , Rr          , Ch          , Ww^Bw\      , Ww^Bw\      , Gg          , Gg          , Gs^Fp       , Wwf         , Gg          , Ww          , Gg          , _off^_usr   , _off^_usr   , _off^_usr   
_off^_usr   , _off^_usr   , _off^_usr   , Rd          , Hh          , Rd          , Mm          , Rd          , Rd          , Ch          , Gg          , Ww          , Wwf         , Ch          , Ch          , Ch          , Wwf         , Ww          , Gg          , Ch          , Rd          , Gg          , Gg          , Ww          , Gs^Fp       , Ww          , _off^_usr   , _off^_usr   , _off^_usr   
_off^_usr   , _off^_usr   , _off^_usr   , Gg          , Gg          , Gs^Fp       , Gg          , Gg          , Gg          , Gg          , Gg          , Hh          , Ss^Vhs      , Ww          , Ww          , Ww          , Gs^Fp       , Hh^Vhh      , Gg^Fet      , Gg          , Rd          , Gg          , Gg          , Gg          , Gg          , Gg          , _off^_usr   , _off^_usr   , _off^_usr   
_off^_usr   , _off^_usr   , _off^_usr   , _off^_usr   , Gg          , Gg          , Gg          , Gg          , Wwf         , Gs^Fp       , Ww          , Ds          , Ss          , Ww          , Mm          , Gg          , Gg          , Mm          , Gg          , Gg          , Rd          , Mm          , Gs^Fp       , Gg          , Gg          , _off^_usr   , _off^_usr   , _off^_usr   , _off^_usr   
_off^_usr   , _off^_usr   , _off^_usr   , _off^_usr   , _off^_usr   , Gg          , Gs^Fp       , Ww          , Gg          , Ww          , Mm^Vhh      , Ww          , Wwf         , Ww          , Ww          , Hh          , Gg          , Gg          , Gg          , Gg          , Gg          , Rd          , Hh          , Gg          , _off^_usr   , _off^_usr   , _off^_usr   , _off^_usr   , _off^_usr   
_off^_usr   , _off^_usr   , _off^_usr   , _off^_usr   , _off^_usr   , Gg          , Ww          , Ww          , Gg          , Hh          , Gs^Fp       , Ds          , Gg          , Gg          , Ds          , Ww          , Gg          , Gg          , Hh          , Gs^Fp       , Gg          , Rd          , Rd          , Gg          , _off^_usr   , _off^_usr   , _off^_usr   , _off^_usr   , _off^_usr   
_off^_usr   , _off^_usr   , _off^_usr   , _off^_usr   , _off^_usr   , _off^_usr   , _off^_usr   , Gg          , Gg          , Gg          , Gg          , Gg          , Gs^Fp       , Gg          , Gg          , Wwf         , Ww          , Ww          , Ww          , Gg          , Gg          , Gg          , _off^_usr   , _off^_usr   , _off^_usr   , _off^_usr   , _off^_usr   , _off^_usr   , _off^_usr   
_off^_usr   , _off^_usr   , _off^_usr   , _off^_usr   , _off^_usr   , _off^_usr   , _off^_usr   , _off^_usr   , _off^_usr   , Gg          , Gg          , Gg          , Gg          , Gg          , Gg          , Gg          , Gg          , Hh          , Ww          , Gg          , _off^_usr   , _off^_usr   , _off^_usr   , _off^_usr   , _off^_usr   , _off^_usr   , _off^_usr   , _off^_usr   , _off^_usr   
_off^_usr   , _off^_usr   , _off^_usr   , _off^_usr   , _off^_usr   , _off^_usr   , _off^_usr   , _off^_usr   , _off^_usr   , _off^_usr   , _off^_usr   , Gg          , _off^_usr   , Gg          , _off^_usr   , Gg          , _off^_usr   , Gg          , _off^_usr   , _off^_usr   , _off^_usr   , _off^_usr   , _off^_usr   , _off^_usr   , _off^_usr   , _off^_usr   , _off^_usr   , _off^_usr   , _off^_usr   
_off^_usr   , _off^_usr   , _off^_usr   , _off^_usr   , _off^_usr   , _off^_usr   , _off^_usr   , _off^_usr   , _off^_usr   , _off^_usr   , _off^_usr   , _off^_usr   , _off^_usr   , _off^_usr   , _off^_usr   , _off^_usr   , _off^_usr   , _off^_usr   , _off^_usr   , _off^_usr   , _off^_usr   , _off^_usr   , _off^_usr   , _off^_usr   , _off^_usr   , _off^_usr   , _off^_usr   , _off^_usr   , _off^_usr   
_off^_usr   , _off^_usr   , _off^_usr   , _off^_usr   , _off^_usr   , _off^_usr   , _off^_usr   , _off^_usr   , _off^_usr   , _off^_usr   , _off^_usr   , _off^_usr   , _off^_usr   , _off^_usr   , _off^_usr   , _off^_usr   , _off^_usr   , _off^_usr   , _off^_usr   , _off^_usr   , _off^_usr   , _off^_usr   , _off^_usr   , _off^_usr   , _off^_usr   , _off^_usr   , _off^_usr   , _off^_usr   , _off^_usr   
