border_size=1
usage=map

_off^_usr   , _off^_usr   , _off^_usr   , _off^_usr   , _off^_usr   , _off^_usr   , _off^_usr   , _off^_usr   , _off^_usr   , _off^_usr   , _off^_usr   , _off^_usr   , _off^_usr   , _off^_usr   , _off^_usr   , _off^_usr   , _off^_usr   , _off^_usr   , _off^_usr   , _off^_usr   , _off^_usr   , _off^_usr   , _off^_usr   , _off^_usr   , _off^_usr   , _off^_usr   , _off^_usr   , _off^_usr   , _off^_usr   
_off^_usr   , _off^_usr   , _off^_usr   , _off^_usr   , _off^_usr   , _off^_usr   , _off^_usr   , _off^_usr   , _off^_usr   , _off^_usr   , _off^_usr   , _off^_usr   , _off^_usr   , _off^_usr   , _off^_usr   , _off^_usr   , _off^_usr   , _off^_usr   , _off^_usr   , _off^_usr   , _off^_usr   , _off^_usr   , _off^_usr   , _off^_usr   , _off^_usr   , _off^_usr   , _off^_usr   , _off^_usr   , _off^_usr   
_off^_usr   , _off^_usr   , _off^_usr   , _off^_usr   , _off^_usr   , _off^_usr   , _off^_usr   , _off^_usr   , _off^_usr   , _off^_usr   , _off^_usr   , _off^_usr   , _off^_usr   , _off^_usr   , _off^_usr   , _off^_usr   , _off^_usr   , _off^_usr   , _off^_usr   , _off^_usr   , _off^_usr   , _off^_usr   , _off^_usr   , _off^_usr   , _off^_usr   , _off^_usr   , _off^_usr   , _off^_usr   , _off^_usr   
_off^_usr   , _off^_usr   , _off^_usr   , _off^_usr   , _off^_usr   , _off^_usr   , _off^_usr   , _off^_usr   , _off^_usr   , _off^_usr   , Dd          , Ww          , Gd^Fts      , Rd          , Dd          , Dd          , Hd          , Rd          , Dd          , _off^_usr   , _off^_usr   , _off^_usr   , _off^_usr   , _off^_usr   , _off^_usr   , _off^_usr   , _off^_usr   , _off^_usr   , _off^_usr   
_off^_usr   , _off^_usr   , _off^_usr   , _off^_usr   , _off^_usr   , _off^_usr   , _off^_usr   , _off^_usr   , Dd          , Dd          , Wwf         , Ww          , Ww          , Rd          , Dd          , Gd^Fts      , Rd          , Rd          , Rd          , Dd          , Rd          , _off^_usr   , _off^_usr   , _off^_usr   , _off^_usr   , _off^_usr   , _off^_usr   , _off^_usr   , _off^_usr   
_off^_usr   , _off^_usr   , _off^_usr   , _off^_usr   , _off^_usr   , _off^_usr   , Gd          , Gd          , Gd          , Dd          , Hd          , Ds          , Wwf         , Rd          , Rd          , Md          , Rd          , Dd          , Gd^Fts      , Rd          , Ww          , Ww          , Ww          , _off^_usr   , _off^_usr   , _off^_usr   , _off^_usr   , _off^_usr   , _off^_usr   
_off^_usr   , _off^_usr   , _off^_usr   , _off^_usr   , _off^_usr   , Gd          , Gd          , Ww          , Gd          , Gd^Fts      , Md^Vdt      , Ww          , Gd^Fts      , Dd          , Rd          , Rd          , Dd          , Dd          , Dd          , Hd          , Ww          , Hd          , Ww          , Dd          , _off^_usr   , _off^_usr   , _off^_usr   , _off^_usr   , _off^_usr   
_off^_usr   , _off^_usr   , _off^_usr   , _off^_usr   , Dd          , Rd          , Dd          , Gd^Fts      , Gd          , Ds          , Ww          , Ww          , Dd          , Dd          , Cd          , Dd          , Dd^Edp      , Dd          , Dd          , Dd          , Dd          , Ww          , Dd          , Dd          , Dd          , _off^_usr   , _off^_usr   , _off^_usr   , _off^_usr   
_off^_usr   , _off^_usr   , _off^_usr   , _off^_usr   , Dd          , Dd          , Dd          , Dd          , Dd          , Wwf         , Ss          , Ds          , Hd          , Dd          , Ww^Bw|      , Dd          , Hd^Do       , Md          , Dd          , Dd          , Ww          , Wwf         , Dd          , Dd          , Rd          , _off^_usr   , _off^_usr   , _off^_usr   , _off^_usr   
_off^_usr   , _off^_usr   , _off^_usr   , Dd          , Ww          , Dd          , Wwf         , Ds          , Ww          , Ww          , Ww          , Ss^Do       , Wwf         , Ww          , Ww^Bw|      , Ww          , Wwf         , Gd^Fts      , Dd^Vda      , Hd          , Ww          , Ds          , Dd          , Dd          , Gd          , Gd          , _off^_usr   , _off^_usr   , _off^_usr   
_off^_usr   , _off^_usr   , _off^_usr   , Ww          , Hd          , Ww          , Dd          , Ww          , Hd          , Md          , Ww          , Ww          , Cd          , Cdr         , 4 Kdr       , Cdr         , Cd          , Ww          , Ww          , Md          , Ww          , Ds          , Gd          , Gd^Fts      , Ww          , Gd          , _off^_usr   , _off^_usr   , _off^_usr   
_off^_usr   , _off^_usr   , _off^_usr   , Ww          , Ww          , Ww          , Dd          , Dd          , Dd          , Dd^Vda      , Ww          , Cd          , Gg^Vda      , Rr          , Ww^Ewf      , Rr          , Gg^Vda      , Cd          , Ww          , Ww          , Ss          , Wwf         , Ds          , Gd          , Gd          , Gd          , _off^_usr   , _off^_usr   , _off^_usr   
_off^_usr   , _off^_usr   , _off^_usr   , Rd          , Rd          , Hd          , Dd          , Dd          , Md          , Gd^Fts      , Wwf         , Cd          , Rr          , Rr          , Rr          , Rr          , Rr          , Cd          , Wwf         , Ss^Do       , Ds          , Ww          , Md^Vdt      , Gd^Fts      , Dd          , Dd          , _off^_usr   , _off^_usr   , _off^_usr   
_off^_usr   , _off^_usr   , _off^_usr   , Dd          , Rd          , Gd^Fts      , Dd          , Dd          , Dd^Edp      , Hd^Do       , Ww          , Cdr         , 2 Kdr       , Ww^Ewf      , Rr          , Ww^Ewf      , 3 Kdr       , Cdr         , Ww          , Hd          , Dd          , Ww          , Ww          , Hd          , Wwf         , Dd          , _off^_usr   , _off^_usr   , _off^_usr   
_off^_usr   , _off^_usr   , _off^_usr   , Dd          , Rd          , Dd          , Rd          , Dd          , Dd          , Dd          , Ww^Bw/      , Ww^Bw/      , Cdr         , Rr          , Gg^Vda      , Rr          , Cdr         , Ww^Bw\      , Ww^Bw\      , Dd          , Dd          , Gd^Fts      , Wwf         , Ds          , Ww          , Dd          , _off^_usr   , _off^_usr   , _off^_usr   
_off^_usr   , _off^_usr   , _off^_usr   , Rd          , Hd          , Rd          , Md          , Rd          , Rd          , Cd          , Dd          , Ww          , Wwf         , Cd          , Cd          , Cd          , Wwf         , Ww          , Dd          , Cd          , Rd          , Dd          , Rd          , Ww          , Gd^Fts      , Ww          , _off^_usr   , _off^_usr   , _off^_usr   
_off^_usr   , _off^_usr   , _off^_usr   , Dd          , Dd          , Gd^Fts      , Dd          , Rd          , Dd          , Dd          , Dd          , Hd          , Ss^Do       , Ww          , Ww          , Ww          , Gd^Fts      , Hd^Do       , Dd^Edp      , Dd          , Rd          , Rd          , Dd          , Rd          , Rd          , Rd          , _off^_usr   , _off^_usr   , _off^_usr   
_off^_usr   , _off^_usr   , _off^_usr   , _off^_usr   , Dd          , Dd          , Rd          , Rd          , Wwf         , Gd^Fts      , Ww          , Ds          , Ss          , Ww          , Md          , Dd^Vda      , Dd          , Md          , Dd          , Dd          , Rd          , Md          , Gd^Fts      , Dd          , Dd          , _off^_usr   , _off^_usr   , _off^_usr   , _off^_usr   
_off^_usr   , _off^_usr   , _off^_usr   , _off^_usr   , _off^_usr   , Rd          , Gd^Fts      , Ww          , Ds          , Ww          , Md^Vdt      , Ww          , Wwf         , Ww          , Ww          , Hd          , Dd          , Dd          , Dd          , Dd          , Dd          , Rd          , Hd          , Dd          , _off^_usr   , _off^_usr   , _off^_usr   , _off^_usr   , _off^_usr   
_off^_usr   , _off^_usr   , _off^_usr   , _off^_usr   , _off^_usr   , Dd          , Ww          , Ww          , Wwf         , Hd          , Gd^Fts      , Ds          , Gd          , Ds          , Ds          , Ww          , Dd          , Dd          , Hd          , Gd^Fts      , Rd          , Rd          , Rd          , Dd          , _off^_usr   , _off^_usr   , _off^_usr   , _off^_usr   , _off^_usr   
_off^_usr   , _off^_usr   , _off^_usr   , _off^_usr   , _off^_usr   , _off^_usr   , _off^_usr   , Dd          , Dd          , Dd          , Gd          , Gd          , Gd^Fts      , Dd          , Dd          , Wwf         , Ww          , Ww          , Ww          , Rd          , Dd          , Dd          , _off^_usr   , _off^_usr   , _off^_usr   , _off^_usr   , _off^_usr   , _off^_usr   , _off^_usr   
_off^_usr   , _off^_usr   , _off^_usr   , _off^_usr   , _off^_usr   , _off^_usr   , _off^_usr   , _off^_usr   , _off^_usr   , Dd          , Gd          , Ww          , Gd          , Dd          , Dd          , Dd          , Ww          , Hd          , Ww          , Rd          , _off^_usr   , _off^_usr   , _off^_usr   , _off^_usr   , _off^_usr   , _off^_usr   , _off^_usr   , _off^_usr   , _off^_usr   
_off^_usr   , _off^_usr   , _off^_usr   , _off^_usr   , _off^_usr   , _off^_usr   , _off^_usr   , _off^_usr   , _off^_usr   , _off^_usr   , _off^_usr   , Gd          , _off^_usr   , Gd          , _off^_usr   , Dd          , _off^_usr   , Ww          , _off^_usr   , _off^_usr   , _off^_usr   , _off^_usr   , _off^_usr   , _off^_usr   , _off^_usr   , _off^_usr   , _off^_usr   , _off^_usr   , _off^_usr   
_off^_usr   , _off^_usr   , _off^_usr   , _off^_usr   , _off^_usr   , _off^_usr   , _off^_usr   , _off^_usr   , _off^_usr   , _off^_usr   , _off^_usr   , _off^_usr   , _off^_usr   , _off^_usr   , _off^_usr   , _off^_usr   , _off^_usr   , _off^_usr   , _off^_usr   , _off^_usr   , _off^_usr   , _off^_usr   , _off^_usr   , _off^_usr   , _off^_usr   , _off^_usr   , _off^_usr   , _off^_usr   , _off^_usr   
_off^_usr   , _off^_usr   , _off^_usr   , _off^_usr   , _off^_usr   , _off^_usr   , _off^_usr   , _off^_usr   , _off^_usr   , _off^_usr   , _off^_usr   , _off^_usr   , _off^_usr   , _off^_usr   , _off^_usr   , _off^_usr   , _off^_usr   , _off^_usr   , _off^_usr   , _off^_usr   , _off^_usr   , _off^_usr   , _off^_usr   , _off^_usr   , _off^_usr   , _off^_usr   , _off^_usr   , _off^_usr   , _off^_usr   
