border_size=1
usage=map

_off^_usr   , _off^_usr   , _off^_usr   , _off^_usr   , _off^_usr   , _off^_usr   , _off^_usr   , _off^_usr   , _off^_usr   , _off^_usr   , _off^_usr   , _off^_usr   , _off^_usr   , _off^_usr   , _off^_usr   , _off^_usr   , _off^_usr   , _off^_usr   , _off^_usr   , _off^_usr   , _off^_usr   , _off^_usr   , _off^_usr   , _off^_usr   , _off^_usr   , _off^_usr   , _off^_usr   , _off^_usr   , _off^_usr   
_off^_usr   , _off^_usr   , _off^_usr   , _off^_usr   , _off^_usr   , _off^_usr   , _off^_usr   , _off^_usr   , _off^_usr   , _off^_usr   , _off^_usr   , _off^_usr   , _off^_usr   , _off^_usr   , _off^_usr   , _off^_usr   , _off^_usr   , _off^_usr   , _off^_usr   , _off^_usr   , _off^_usr   , _off^_usr   , _off^_usr   , _off^_usr   , _off^_usr   , _off^_usr   , _off^_usr   , _off^_usr   , _off^_usr   
_off^_usr   , _off^_usr   , _off^_usr   , _off^_usr   , _off^_usr   , _off^_usr   , _off^_usr   , _off^_usr   , _off^_usr   , _off^_usr   , _off^_usr   , _off^_usr   , _off^_usr   , _off^_usr   , _off^_usr   , _off^_usr   , _off^_usr   , _off^_usr   , _off^_usr   , _off^_usr   , _off^_usr   , _off^_usr   , _off^_usr   , _off^_usr   , _off^_usr   , _off^_usr   , _off^_usr   , _off^_usr   , _off^_usr   
_off^_usr   , _off^_usr   , _off^_usr   , _off^_usr   , _off^_usr   , _off^_usr   , _off^_usr   , _off^_usr   , _off^_usr   , _off^_usr   , Dd          , Ww          , Gd^Fts      , Dd          , Dd          , Dd          , Hd          , Rd          , Dd          , _off^_usr   , _off^_usr   , _off^_usr   , _off^_usr   , _off^_usr   , _off^_usr   , _off^_usr   , _off^_usr   , _off^_usr   , _off^_usr   
_off^_usr   , _off^_usr   , _off^_usr   , _off^_usr   , _off^_usr   , _off^_usr   , _off^_usr   , _off^_usr   , Dd          , Dd          , Dd          , Ww          , Ww          , Dd          , Dd          , Gd^Fts      , Rd          , Rd          , Dd          , Dd          , Dd          , _off^_usr   , _off^_usr   , _off^_usr   , _off^_usr   , _off^_usr   , _off^_usr   , _off^_usr   , _off^_usr   
_off^_usr   , _off^_usr   , _off^_usr   , _off^_usr   , _off^_usr   , _off^_usr   , Dd          , Dd          , Dd          , Dd          , Hd          , Dd          , Wwf         , Dd          , Dd          , Md          , Rd          , Dd          , Gd^Fts      , Dd          , Ww          , Ww          , Dd          , _off^_usr   , _off^_usr   , _off^_usr   , _off^_usr   , _off^_usr   , _off^_usr   
_off^_usr   , _off^_usr   , _off^_usr   , _off^_usr   , _off^_usr   , Dd          , Dd          , Dd          , Dd          , Gd^Fts      , Md^Vdt      , Ww          , Gd^Fts      , Dd          , Rd          , Rd          , Dd          , Dd          , Dd          , Hd          , Ww          , Hd          , Dd          , Dd          , _off^_usr   , _off^_usr   , _off^_usr   , _off^_usr   , _off^_usr   
_off^_usr   , _off^_usr   , _off^_usr   , _off^_usr   , Dd          , Dd          , Dd          , Gd^Fts      , Dd          , Ds          , Ww          , Ww          , Dd          , Dd          , Cd          , Dd          , Dd^Edp      , Dd          , Dd          , Dd          , Dd          , Ww          , Dd          , Dd          , Dd          , _off^_usr   , _off^_usr   , _off^_usr   , _off^_usr   
_off^_usr   , _off^_usr   , _off^_usr   , _off^_usr   , Dd          , Dd          , Dd          , Dd          , Dd          , Wwf         , Ss          , Ds          , Hd          , Dd          , Ww^Bw|      , Dd          , Hd^Do       , Md          , Dd          , Dd          , Ww          , Wwf         , Dd          , Dd          , Dd          , _off^_usr   , _off^_usr   , _off^_usr   , _off^_usr   
_off^_usr   , _off^_usr   , _off^_usr   , Dd          , Dd          , Dd          , Wwf         , Ds          , Ww          , Ww          , Ww          , Ss^Do       , Wwf         , Ww          , Ww^Bw|      , Ww          , Wwf         , Gd^Fts      , Dd          , Hd          , Ww          , Ds          , Dd          , Dd          , Dd          , Dd          , _off^_usr   , _off^_usr   , _off^_usr   
_off^_usr   , _off^_usr   , _off^_usr   , Dd          , Hd          , Ww          , Dd          , Ww          , Hd          , Md          , Ww          , Ww          , Cd          , Cdr         , 4 Kdr       , Cdr         , Cd          , Ww          , Ww          , Md          , Ww          , Dd          , Dd          , Gd^Fts      , Dd          , Dd          , _off^_usr   , _off^_usr   , _off^_usr   
_off^_usr   , _off^_usr   , _off^_usr   , Ww          , Ww          , Ww          , Dd          , Dd          , Dd          , Dd          , Ww          , Cd          , Gg^Vda      , Rr          , Ww^Ewf      , Rr          , Gg^Vda      , Cd          , Ww          , Ww          , Ss          , Wwf         , Ds          , Dd          , Dd          , Dd          , _off^_usr   , _off^_usr   , _off^_usr   
_off^_usr   , _off^_usr   , _off^_usr   , Dd          , Dd          , Hd          , Dd          , Dd          , Md          , Gd^Fts      , Wwf         , Cd          , Rr          , Rr          , Rr          , Rr          , Rr          , Cd          , Wwf         , Ss^Do       , Ds          , Ww          , Md^Vdt      , Gd^Fts      , Dd          , Dd          , _off^_usr   , _off^_usr   , _off^_usr   
_off^_usr   , _off^_usr   , _off^_usr   , Dd          , Dd          , Gd^Fts      , Dd          , Dd          , Dd^Edp      , Hd^Do       , Ww          , Cdr         , 2 Kdr       , Ww^Ewf      , Rr          , Ww^Ewf      , 3 Kdr       , Cdr         , Ww          , Hd          , Dd          , Ww          , Ww          , Hd          , Dd          , Dd          , _off^_usr   , _off^_usr   , _off^_usr   
_off^_usr   , _off^_usr   , _off^_usr   , Dd          , Rd          , Dd          , Rd          , Dd          , Dd          , Dd          , Ww^Bw/      , Ww^Bw/      , Cdr         , Rr          , Gg^Vda      , Rr          , Cdr         , Ww^Bw\      , Ww^Bw\      , Dd          , Dd          , Gd^Fts      , Wwf         , Dd          , Ww          , Dd          , _off^_usr   , _off^_usr   , _off^_usr   
_off^_usr   , _off^_usr   , _off^_usr   , Rd          , Hd          , Rd          , Md          , Rd          , Rd          , Cd          , Dd          , Ww          , Wwf         , Cd          , Cd          , Cd          , Wwf         , Ww          , Dd          , Cd          , Rd          , Dd          , Dd          , Ww          , Gd^Fts      , Ww          , _off^_usr   , _off^_usr   , _off^_usr   
_off^_usr   , _off^_usr   , _off^_usr   , Dd          , Dd          , Gd^Fts      , Dd          , Dd          , Dd          , Dd          , Dd          , Hd          , Ss^Do       , Ww          , Ww          , Ww          , Gd^Fts      , Hd^Do       , Dd^Edp      , Dd          , Rd          , Dd          , Dd          , Dd          , Dd          , Dd          , _off^_usr   , _off^_usr   , _off^_usr   
_off^_usr   , _off^_usr   , _off^_usr   , _off^_usr   , Dd          , Dd          , Dd          , Dd          , Wwf         , Gd^Fts      , Ww          , Ds          , Ss          , Ww          , Md          , Dd          , Dd          , Md          , Dd          , Dd          , Rd          , Md          , Gd^Fts      , Dd          , Dd          , _off^_usr   , _off^_usr   , _off^_usr   , _off^_usr   
_off^_usr   , _off^_usr   , _off^_usr   , _off^_usr   , _off^_usr   , Dd          , Gd^Fts      , Ww          , Dd          , Ww          , Md^Vdt      , Ww          , Wwf         , Ww          , Ww          , Hd          , Dd          , Dd          , Dd          , Dd          , Dd          , Rd          , Hd          , Dd          , _off^_usr   , _off^_usr   , _off^_usr   , _off^_usr   , _off^_usr   
_off^_usr   , _off^_usr   , _off^_usr   , _off^_usr   , _off^_usr   , Dd          , Ww          , Ww          , Dd          , Hd          , Gd^Fts      , Ds          , Dd          , Dd          , Ds          , Ww          , Dd          , Dd          , Hd          , Gd^Fts      , Dd          , Rd          , Rd          , Dd          , _off^_usr   , _off^_usr   , _off^_usr   , _off^_usr   , _off^_usr   
_off^_usr   , _off^_usr   , _off^_usr   , _off^_usr   , _off^_usr   , _off^_usr   , _off^_usr   , Dd          , Dd          , Dd          , Dd          , Dd          , Gd^Fts      , Dd          , Dd          , Wwf         , Ww          , Ww          , Ww          , Dd          , Dd          , Dd          , _off^_usr   , _off^_usr   , _off^_usr   , _off^_usr   , _off^_usr   , _off^_usr   , _off^_usr   
_off^_usr   , _off^_usr   , _off^_usr   , _off^_usr   , _off^_usr   , _off^_usr   , _off^_usr   , _off^_usr   , _off^_usr   , Dd          , Dd          , Dd          , Dd          , Dd          , Dd          , Dd          , Dd          , Hd          , Ww          , Dd          , _off^_usr   , _off^_usr   , _off^_usr   , _off^_usr   , _off^_usr   , _off^_usr   , _off^_usr   , _off^_usr   , _off^_usr   
_off^_usr   , _off^_usr   , _off^_usr   , _off^_usr   , _off^_usr   , _off^_usr   , _off^_usr   , _off^_usr   , _off^_usr   , _off^_usr   , _off^_usr   , Dd          , _off^_usr   , Dd          , _off^_usr   , Dd          , _off^_usr   , Dd          , _off^_usr   , _off^_usr   , _off^_usr   , _off^_usr   , _off^_usr   , _off^_usr   , _off^_usr   , _off^_usr   , _off^_usr   , _off^_usr   , _off^_usr   
_off^_usr   , _off^_usr   , _off^_usr   , _off^_usr   , _off^_usr   , _off^_usr   , _off^_usr   , _off^_usr   , _off^_usr   , _off^_usr   , _off^_usr   , _off^_usr   , _off^_usr   , _off^_usr   , _off^_usr   , _off^_usr   , _off^_usr   , _off^_usr   , _off^_usr   , _off^_usr   , _off^_usr   , _off^_usr   , _off^_usr   , _off^_usr   , _off^_usr   , _off^_usr   , _off^_usr   , _off^_usr   , _off^_usr   
_off^_usr   , _off^_usr   , _off^_usr   , _off^_usr   , _off^_usr   , _off^_usr   , _off^_usr   , _off^_usr   , _off^_usr   , _off^_usr   , _off^_usr   , _off^_usr   , _off^_usr   , _off^_usr   , _off^_usr   , _off^_usr   , _off^_usr   , _off^_usr   , _off^_usr   , _off^_usr   , _off^_usr   , _off^_usr   , _off^_usr   , _off^_usr   , _off^_usr   , _off^_usr   , _off^_usr   , _off^_usr   , _off^_usr   
