border_size=1
usage=map

_off^_usr   , _off^_usr   , _off^_usr   , _off^_usr   , _off^_usr   , _off^_usr   , _off^_usr   , _off^_usr   , _off^_usr   , _off^_usr   , _off^_usr   , _off^_usr   , _off^_usr   , _off^_usr   , _off^_usr   , _off^_usr   , _off^_usr   , _off^_usr   , _off^_usr   , _off^_usr   , _off^_usr   , _off^_usr   , _off^_usr   , _off^_usr   , _off^_usr   , _off^_usr   , _off^_usr   , _off^_usr   , _off^_usr   
_off^_usr   , _off^_usr   , _off^_usr   , _off^_usr   , _off^_usr   , _off^_usr   , _off^_usr   , _off^_usr   , _off^_usr   , _off^_usr   , _off^_usr   , _off^_usr   , _off^_usr   , _off^_usr   , _off^_usr   , _off^_usr   , _off^_usr   , _off^_usr   , _off^_usr   , _off^_usr   , _off^_usr   , _off^_usr   , _off^_usr   , _off^_usr   , _off^_usr   , _off^_usr   , _off^_usr   , _off^_usr   , _off^_usr   
_off^_usr   , _off^_usr   , _off^_usr   , _off^_usr   , _off^_usr   , _off^_usr   , _off^_usr   , _off^_usr   , _off^_usr   , _off^_usr   , _off^_usr   , _off^_usr   , _off^_usr   , _off^_usr   , _off^_usr   , _off^_usr   , _off^_usr   , _off^_usr   , _off^_usr   , _off^_usr   , _off^_usr   , _off^_usr   , _off^_usr   , _off^_usr   , _off^_usr   , _off^_usr   , _off^_usr   , _off^_usr   , _off^_usr   
_off^_usr   , _off^_usr   , _off^_usr   , _off^_usr   , _off^_usr   , _off^_usr   , _off^_usr   , _off^_usr   , _off^_usr   , _off^_usr   , Aa          , Ww          , Ha^Fpa      , Aa          , Aa          , Aa          , Ha          , Rb          , Aa          , _off^_usr   , _off^_usr   , _off^_usr   , _off^_usr   , _off^_usr   , _off^_usr   , _off^_usr   , _off^_usr   , _off^_usr   , _off^_usr   
_off^_usr   , _off^_usr   , _off^_usr   , _off^_usr   , _off^_usr   , _off^_usr   , _off^_usr   , _off^_usr   , Aa          , Aa          , Aa          , Ww          , Ww          , Aa          , Aa          , Ha^Fpa      , Rb          , Rb          , Aa          , Aa          , Aa          , _off^_usr   , _off^_usr   , _off^_usr   , _off^_usr   , _off^_usr   , _off^_usr   , _off^_usr   , _off^_usr   
_off^_usr   , _off^_usr   , _off^_usr   , _off^_usr   , _off^_usr   , _off^_usr   , Aa          , Aa          , Aa          , Aa          , Ha          , Aa          , Ai          , Aa          , Aa          , Ms          , Rb          , Aa          , Ha^Fpa      , Aa          , Ww          , Ww          , Aa          , _off^_usr   , _off^_usr   , _off^_usr   , _off^_usr   , _off^_usr   , _off^_usr   
_off^_usr   , _off^_usr   , _off^_usr   , _off^_usr   , _off^_usr   , Aa          , Aa          , Aa          , Aa          , Ha^Fpa      , Ms^Voa      , Ww          , Ha^Fpa      , Aa          , Rb          , Rb          , Aa          , Aa          , Aa          , Ha          , Ww          , Ha          , Aa          , Aa          , _off^_usr   , _off^_usr   , _off^_usr   , _off^_usr   , _off^_usr   
_off^_usr   , _off^_usr   , _off^_usr   , _off^_usr   , Aa          , Aa          , Aa          , Ha^Fpa      , Aa          , Ai          , Ww          , Ww          , Aa          , Aa          , Cea^Ecf     , Aa          , Aa^Fda      , Aa          , Aa          , Aa          , Aa          , Ww          , Aa          , Aa          , Aa          , _off^_usr   , _off^_usr   , _off^_usr   , _off^_usr   
_off^_usr   , _off^_usr   , _off^_usr   , _off^_usr   , Aa          , Aa          , Aa          , Aa          , Aa          , Ai          , Wwf         , Ai          , Ha          , Aa          , Ww^Bw|      , Aa          , Ha^Vhha     , Ms          , Aa          , Aa          , Ww          , Ai          , Aa          , Aa          , Aa          , _off^_usr   , _off^_usr   , _off^_usr   , _off^_usr   
_off^_usr   , _off^_usr   , _off^_usr   , Aa          , Aa          , Aa          , Ai          , Ai          , Ww          , Ww          , Ww          , Ai^Vaa      , Ai          , Ww          , Ww^Bw|      , Ww          , Ai          , Ha^Fpa      , Aa          , Ha          , Ww          , Ai          , Aa          , Aa          , Aa          , Aa          , _off^_usr   , _off^_usr   , _off^_usr   
_off^_usr   , _off^_usr   , _off^_usr   , Aa          , Ha          , Ww          , Aa          , Ww          , Ha          , Ww          , Ww          , Ww          , Cha         , Cha         , 4 Kha       , Cha         , Cha         , Ai          , Ww          , Ww          , Ww          , Aa          , Aa          , Ha^Fpa      , Aa          , Aa          , _off^_usr   , _off^_usr   , _off^_usr   
_off^_usr   , _off^_usr   , _off^_usr   , Ww          , Ww          , Ww          , Aa          , Aa          , Aa          , Aa          , Ai          , Cha         , Gg^Vea      , Rr          , Rr          , Rr          , Gg^Vea      , Cha         , Ww          , Ww          , Wwf         , Ai          , Ai          , Aa          , Aa          , Aa          , _off^_usr   , _off^_usr   , _off^_usr   
_off^_usr   , _off^_usr   , _off^_usr   , Aa          , Aa          , Ha          , Aa          , Aa          , Ms          , Ha^Fpa      , Ai          , Cha         , Rr          , Rr          , Rr          , Rr          , Rr          , Cha         , Ai          , Ai^Vaa      , Ai          , Ww          , Ms^Voa      , Ha^Fpa      , Aa          , Aa          , _off^_usr   , _off^_usr   , _off^_usr   
_off^_usr   , _off^_usr   , _off^_usr   , Aa          , Aa          , Ha^Fpa      , Aa          , Aa          , Aa^Fda      , Ha^Vhha     , Ww          , Cha         , 2 Kha       , Rr          , Rr          , Rr          , 3 Kha       , Cha         , Ww          , Ha          , Aa          , Ww          , Ww          , Ha          , Aa          , Aa          , _off^_usr   , _off^_usr   , _off^_usr   
_off^_usr   , _off^_usr   , _off^_usr   , Aa          , Rb          , Aa          , Rb          , Aa          , Aa          , Aa          , Ww^Bw/      , Ww^Bw/      , Cha         , Rr          , Gg^Vea      , Rr          , Cha         , Ww^Bw\      , Ww^Bw\      , Aa          , Aa          , Ha^Fpa      , Ai          , Aa          , Ww          , Aa          , _off^_usr   , _off^_usr   , _off^_usr   
_off^_usr   , _off^_usr   , _off^_usr   , Rb          , Ha          , Rb          , Ms          , Rb          , Rb          , Cea^Ecf     , Aa          , Ww          , Ai          , Cha         , Cha         , Cha         , Ai          , Ww          , Aa          , Cea^Ecf     , Rb          , Aa          , Aa          , Ww          , Ha^Fpa      , Ww          , _off^_usr   , _off^_usr   , _off^_usr   
_off^_usr   , _off^_usr   , _off^_usr   , Aa          , Aa          , Ha^Fpa      , Aa          , Aa          , Aa          , Aa          , Aa          , Ha          , Ai^Vaa      , Ww          , Ww          , Ai          , Ha^Fpa      , Ha^Vhha     , Aa^Fda      , Aa          , Rb          , Aa          , Aa          , Aa          , Aa          , Aa          , _off^_usr   , _off^_usr   , _off^_usr   
_off^_usr   , _off^_usr   , _off^_usr   , _off^_usr   , Aa          , Aa          , Aa          , Aa          , Ai          , Ha^Fpa      , Ww          , Ai          , Wwf         , Ww          , Ww          , Aa          , Aa          , Ms          , Aa          , Aa          , Rb          , Ms          , Ha^Fpa      , Aa          , Aa          , _off^_usr   , _off^_usr   , _off^_usr   , _off^_usr   
_off^_usr   , _off^_usr   , _off^_usr   , _off^_usr   , _off^_usr   , Aa          , Ha^Fpa      , Ww          , Aa          , Ww          , Ms^Voa      , Ww          , Ai          , Ww          , Ww          , Ha          , Aa          , Aa          , Aa          , Aa          , Aa          , Rb          , Ha          , Aa          , _off^_usr   , _off^_usr   , _off^_usr   , _off^_usr   , _off^_usr   
_off^_usr   , _off^_usr   , _off^_usr   , _off^_usr   , _off^_usr   , Aa          , Ww          , Ww          , Aa          , Ha          , Ha^Fpa      , Ai          , Aa          , Aa          , Ai          , Ww          , Aa          , Aa          , Ha          , Ha^Fpa      , Aa          , Rb          , Rb          , Aa          , _off^_usr   , _off^_usr   , _off^_usr   , _off^_usr   , _off^_usr   
_off^_usr   , _off^_usr   , _off^_usr   , _off^_usr   , _off^_usr   , _off^_usr   , _off^_usr   , Aa          , Aa          , Aa          , Aa          , Aa          , Ha^Fpa      , Aa          , Aa          , Ai          , Ww          , Ww          , Ww          , Aa          , Aa          , Aa          , _off^_usr   , _off^_usr   , _off^_usr   , _off^_usr   , _off^_usr   , _off^_usr   , _off^_usr   
_off^_usr   , _off^_usr   , _off^_usr   , _off^_usr   , _off^_usr   , _off^_usr   , _off^_usr   , _off^_usr   , _off^_usr   , Aa          , Aa          , Aa          , Aa          , Aa          , Aa          , Aa          , Aa          , Ha          , Ww          , Aa          , _off^_usr   , _off^_usr   , _off^_usr   , _off^_usr   , _off^_usr   , _off^_usr   , _off^_usr   , _off^_usr   , _off^_usr   
_off^_usr   , _off^_usr   , _off^_usr   , _off^_usr   , _off^_usr   , _off^_usr   , _off^_usr   , _off^_usr   , _off^_usr   , _off^_usr   , _off^_usr   , Aa          , _off^_usr   , Aa          , _off^_usr   , Aa          , _off^_usr   , Aa          , _off^_usr   , _off^_usr   , _off^_usr   , _off^_usr   , _off^_usr   , _off^_usr   , _off^_usr   , _off^_usr   , _off^_usr   , _off^_usr   , _off^_usr   
_off^_usr   , _off^_usr   , _off^_usr   , _off^_usr   , _off^_usr   , _off^_usr   , _off^_usr   , _off^_usr   , _off^_usr   , _off^_usr   , _off^_usr   , _off^_usr   , _off^_usr   , _off^_usr   , _off^_usr   , _off^_usr   , _off^_usr   , _off^_usr   , _off^_usr   , _off^_usr   , _off^_usr   , _off^_usr   , _off^_usr   , _off^_usr   , _off^_usr   , _off^_usr   , _off^_usr   , _off^_usr   , _off^_usr   
_off^_usr   , _off^_usr   , _off^_usr   , _off^_usr   , _off^_usr   , _off^_usr   , _off^_usr   , _off^_usr   , _off^_usr   , _off^_usr   , _off^_usr   , _off^_usr   , _off^_usr   , _off^_usr   , _off^_usr   , _off^_usr   , _off^_usr   , _off^_usr   , _off^_usr   , _off^_usr   , _off^_usr   , _off^_usr   , _off^_usr   , _off^_usr   , _off^_usr   , _off^_usr   , _off^_usr   , _off^_usr   , _off^_usr   
